[console_scripts]
wai-annotations = wai.annotations.main:sys_main

[wai.annotations.plugins]
check-duplicate-filenames = wai.annotations.isp.duplicate_filenames.specifier:DuplicateFileNamesISPSpecifier
clean-transcript = wai.annotations.isp.clean_transcript.specifier:CleanTranscriptISPSpecifier
coerce-box = wai.annotations.isp.coercions.specifier:BoxBoundsCoercionISPSpecifier
coerce-mask = wai.annotations.isp.coercions.specifier:MaskBoundsCoercionISPSpecifier
convert-image-format = wai.annotations.isp.convert_image_format.specifier:ConvertImageFormatISPSpecifier
dimension-discarder = wai.annotations.isp.dimension_discarder.specifier:DimensionDiscarderISPSpecifier
discard-invalid-images = wai.annotations.isp.discard_invalid_images.specifier:DiscardInvalidImagesISPSpecifier
discard-negatives = wai.annotations.isp.discard_negatives.specifier:DiscardNegativesISPSpecifier
filter-labels = wai.annotations.isp.filter_labels.specifier:FilterLabelsISPSpecifier
filter-metadata = wai.annotations.isp.filter_metadata.specifier:FilterMetadataISPSpecifier
from-audio-files-ac = wai.annotations.format.audio.specifier:AudioACInputFormatSpecifier
from-audio-files-sp = wai.annotations.format.audio.specifier:AudioSPInputFormatSpecifier
from-images-ic = wai.annotations.format.image.specifier:ImagesICInputFormatSpecifier
from-images-is = wai.annotations.format.image.specifier:ImagesISInputFormatSpecifier
from-images-od = wai.annotations.format.image.specifier:ImagesODInputFormatSpecifier
from-spectra-sc = wai.annotations.format.spectra.specifier:SpectraSCInputFormatSpecifier
label-present = wai.annotations.isp.label_present.specifier:LabelPresentISPSpecifier
map-labels = wai.annotations.isp.map_labels.specifier:MapLabelsISPSpecifier
od-to-ic = wai.annotations.xdc.od_to_ic.specifier:OD2ICXDCSpecifier
od-to-is = wai.annotations.xdc.od_to_is.specifier:OD2ISXDCSpecifier
passthrough = wai.annotations.isp.passthrough.specifier:PassThroughISPSpecifier
polygon-discarder = wai.annotations.isp.polygon_discarder.specifier:PolygonDiscarderISPSpecifier
remove-classes = wai.annotations.isp.remove_classes.specifier:RemoveClassesISPSpecifier
rename = wai.annotations.isp.rename.specifier:RenameISPSpecifier
sample = wai.annotations.isp.sample.specifier:SampleISPSpecifier
strip-annotations = wai.annotations.isp.strip_annotations.specifier:StripAnnotationsISPSpecifier
to-audio-files-ac = wai.annotations.format.audio.specifier:AudioACOutputFormatSpecifier
to-audio-files-sp = wai.annotations.format.audio.specifier:AudioSPOutputFormatSpecifier
to-images-ic = wai.annotations.format.image.specifier:ImagesICOutputFormatSpecifier
to-images-is = wai.annotations.format.image.specifier:ImagesISOutputFormatSpecifier
to-images-od = wai.annotations.format.image.specifier:ImagesODOutputFormatSpecifier
to-spectra-sc = wai.annotations.format.spectra.specifier:SpectraSCOutputFormatSpecifier
to-void-ac = wai.annotations.format.void.specifier:VoidACOutputFormatSpecifier
to-void-ic = wai.annotations.format.void.specifier:VoidICOutputFormatSpecifier
to-void-is = wai.annotations.format.void.specifier:VoidISOutputFormatSpecifier
to-void-od = wai.annotations.format.void.specifier:VoidODOutputFormatSpecifier
to-void-sc = wai.annotations.format.void.specifier:VoidSCOutputFormatSpecifier
to-void-sp = wai.annotations.format.void.specifier:VoidSPOutputFormatSpecifier
write-labels = wai.annotations.isp.write_labels.specifier:WriteLabelsISPSpecifier

